{
  "Ŷ" : "Y",
  "ŷ" : "y",
  "Ÿ" : "Y",
  "Ź" : "Z",
  "ź" : "z",
  "Ż" : "Z",
  "ż" : "z",
  "Ž" : "Z",
  "ž" : "z",
  "ſ" : "ſ",
  "ƀ" : "ƀ",
  "Ɓ" : "Ɓ",
  "Ƃ" : "Ƃ",
  "ƃ" : "ƃ",
  "Ƅ" : "Ƅ",
  "ƅ" : "ƅ",
  "Ɔ" : "Ɔ",
  "Ƈ" : "Ƈ",
  "ƈ" : "ƈ",
  "Ɖ" : "Ɖ",
  "Ɗ" : "Ɗ",
  "Ƌ" : "Ƌ",
  "ƌ" : "ƌ",
  "ƍ" : "ƍ",
  "Ǝ" : "Ǝ",
  "Ə" : "Ə",
  "Ɛ" : "Ɛ",
  "Ƒ" : "Ƒ",
  "ƒ" : "ƒ",
  "À" : "A",
  "Ɠ" : "Ɠ",
  "Á" : "A",
  "Ɣ" : "Ɣ",
  "Â" : "A",
  "ƕ" : "ƕ",
  "Ã" : "A",
  "Ɩ" : "Ɩ",
  "Ä" : "A",
  "Ɨ" : "Ɨ",
  "Å" : "A",
  "Ƙ" : "Ƙ",
  "Æ" : "Æ",
  "ƙ" : "ƙ",
  "Ç" : "C",
  "ƚ" : "ƚ",
  "È" : "E",
  "ƛ" : "ƛ",
  "É" : "E",
  "Ɯ" : "Ɯ",
  "Ê" : "E",
  "Ɲ" : "Ɲ",
  "Ë" : "E",
  "ƞ" : "ƞ",
  "Ì" : "I",
  "Ɵ" : "Ɵ",
  "Í" : "I",
  "Ơ" : "O",
  "Î" : "I",
  "ơ" : "o",
  "Ï" : "I",
  "Ƣ" : "Ƣ",
  "Ð" : "Ð",
  "ƣ" : "ƣ",
  "Ñ" : "N",
  "Ƥ" : "Ƥ",
  "Ò" : "O",
  "ƥ" : "ƥ",
  "Ó" : "O",
  "Ʀ" : "Ʀ",
  "Ô" : "O",
  "Ƨ" : "Ƨ",
  "Õ" : "O",
  "ƨ" : "ƨ",
  "Ö" : "O",
  "Ʃ" : "Ʃ",
  "×" : "×",
  "ƪ" : "ƪ",
  "Ø" : "Ø",
  "ƫ" : "ƫ",
  "Ù" : "U",
  "Ƭ" : "Ƭ",
  "Ú" : "U",
  "ƭ" : "ƭ",
  "Û" : "U",
  "Ʈ" : "Ʈ",
  "Ü" : "U",
  "Ư" : "U",
  "Ý" : "Y",
  "ư" : "u",
  "Þ" : "Þ",
  "Ʊ" : "Ʊ",
  "ß" : "ß",
  "Ʋ" : "Ʋ",
  "à" : "a",
  "Ƴ" : "Ƴ",
  "á" : "a",
  "ƴ" : "ƴ",
  "â" : "a",
  "Ƶ" : "Ƶ",
  "ã" : "a",
  "ƶ" : "ƶ",
  "ä" : "a",
  "Ʒ" : "Ʒ",
  "å" : "a",
  "Ƹ" : "Ƹ",
  "æ" : "æ",
  "ƹ" : "ƹ",
  "ç" : "c",
  "ƺ" : "ƺ",
  "è" : "e",
  "ƻ" : "ƻ",
  "é" : "e",
  "Ƽ" : "Ƽ",
  "ê" : "e",
  "ƽ" : "ƽ",
  "ë" : "e",
  "ƾ" : "ƾ",
  "ì" : "i",
  "ƿ" : "ƿ",
  "í" : "i",
  "ǀ" : "ǀ",
  "î" : "i",
  "ǁ" : "ǁ",
  "ï" : "i",
  "ǂ" : "ǂ",
  "ð" : "ð",
  "ǃ" : "ǃ",
  "ñ" : "n",
  "Ǆ" : "Ǆ",
  "ò" : "o",
  "ǅ" : "ǅ",
  "ó" : "o",
  "ǆ" : "ǆ",
  "ô" : "o",
  "Ǉ" : "Ǉ",
  "õ" : "o",
  "ǈ" : "ǈ",
  "ö" : "o",
  "ǉ" : "ǉ",
  "÷" : "÷",
  "Ǌ" : "Ǌ",
  "ø" : "ø",
  "ǋ" : "ǋ",
  "ù" : "u",
  "ǌ" : "ǌ",
  "ú" : "u",
  "Ǎ" : "A",
  "û" : "u",
  "ǎ" : "a",
  "ü" : "u",
  "Ǐ" : "I",
  "ý" : "y",
  "ǐ" : "i",
  "þ" : "þ",
  "Ǒ" : "O",
  "ÿ" : "y",
  "ǒ" : "o",
  "Ā" : "A",
  "Ǔ" : "U",
  "ā" : "a",
  "ǔ" : "u",
  "Ă" : "A",
  "Ǖ" : "U",
  "ă" : "a",
  "ǖ" : "u",
  "Ą" : "A",
  "Ǘ" : "U",
  "ą" : "a",
  "ǘ" : "u",
  "Ć" : "C",
  "Ǚ" : "U",
  "ć" : "c",
  "ǚ" : "u",
  "Ĉ" : "C",
  "Ǜ" : "U",
  "ĉ" : "c",
  "ǜ" : "u",
  "Ċ" : "C",
  "ǝ" : "ǝ",
  "ċ" : "c",
  "Ǟ" : "A",
  "Č" : "C",
  "ǟ" : "a",
  "č" : "c",
  "Ǡ" : "A",
  "Ď" : "D",
  "ǡ" : "a",
  "ď" : "d",
  "Ǣ" : "Æ",
  "Đ" : "Đ",
  "ǣ" : "æ",
  "đ" : "đ",
  "Ǥ" : "Ǥ",
  "Ē" : "E",
  "ǥ" : "ǥ",
  "ē" : "e",
  "Ǧ" : "G",
  "Ĕ" : "E",
  "ǧ" : "g",
  "ĕ" : "e",
  "Ǩ" : "K",
  "Ė" : "E",
  "ǩ" : "k",
  "ė" : "e",
  "Ǫ" : "O",
  "Ę" : "E",
  "ǫ" : "o",
  "ę" : "e",
  "Ǭ" : "O",
  "Ě" : "E",
  "ǭ" : "o",
  "ě" : "e",
  "Ǯ" : "Ʒ",
  "Ĝ" : "G",
  "ǯ" : "ʒ",
  "ĝ" : "g",
  "ǰ" : "j",
  "Ğ" : "G",
  "Ǳ" : "Ǳ",
  "ğ" : "g",
  "ǲ" : "ǲ",
  "Ġ" : "G",
  "ǳ" : "ǳ",
  "ġ" : "g",
  "Ǵ" : "G",
  "Ģ" : "G",
  "ǵ" : "g",
  "ģ" : "g",
  "Ƕ" : "Ƕ",
  "Ĥ" : "H",
  "Ƿ" : "Ƿ",
  "ĥ" : "h",
  "Ǹ" : "N",
  "Ħ" : "Ħ",
  "ǹ" : "n",
  "ħ" : "ħ",
  "Ǻ" : "A",
  "Ĩ" : "I",
  "ǻ" : "a",
  "ĩ" : "i",
  "Ǽ" : "Æ",
  "Ī" : "I",
  "ǽ" : "æ",
  "ī" : "i",
  "Ǿ" : "Ø",
  "Ĭ" : "I",
  "ǿ" : "ø",
  "ĭ" : "i",
  "Ȁ" : "A",
  "Į" : "I",
  "ȁ" : "a",
  "į" : "i",
  "Ȃ" : "A",
  "İ" : "I",
  "ȃ" : "a",
  "ı" : "ı",
  "Ȅ" : "E",
  "Ĳ" : "Ĳ",
  "ȅ" : "e",
  "ĳ" : "ĳ",
  "Ȇ" : "E",
  "Ĵ" : "J",
  "ȇ" : "e",
  "ĵ" : "j",
  "Ȉ" : "I",
  "Ķ" : "K",
  "ȉ" : "i",
  "ķ" : "k",
  "Ȋ" : "I",
  "ĸ" : "ĸ",
  "ȋ" : "i",
  "Ĺ" : "L",
  "Ȍ" : "O",
  "ĺ" : "l",
  "ȍ" : "o",
  "Ļ" : "L",
  "Ȏ" : "O",
  "ļ" : "l",
  "ȏ" : "o",
  "Ľ" : "L",
  "Ȑ" : "R",
  "ľ" : "l",
  "ȑ" : "r",
  "Ŀ" : "Ŀ",
  "Ȓ" : "R",
  "ŀ" : "ŀ",
  "ȓ" : "r",
  "Ł" : "Ł",
  "Ȕ" : "U",
  "ł" : "ł",
  "ȕ" : "u",
  "Ń" : "N",
  "Ȗ" : "U",
  "ń" : "n",
  "ȗ" : "u",
  "Ņ" : "N",
  "Ș" : "S",
  "ņ" : "n",
  "ș" : "s",
  "Ň" : "N",
  "Ț" : "T",
  "ň" : "n",
  "ț" : "t",
  "ŉ" : "ŉ",
  "Ȝ" : "Ȝ",
  "Ŋ" : "Ŋ",
  "ȝ" : "ȝ",
  "ŋ" : "ŋ",
  "Ȟ" : "H",
  "Ō" : "O",
  "ȟ" : "h",
  "ō" : "o",
  "Ƞ" : "Ƞ",
  "Ŏ" : "O",
  "ȡ" : "ȡ",
  "ŏ" : "o",
  "Ȣ" : "Ȣ",
  "Ő" : "O",
  "ȣ" : "ȣ",
  "ő" : "o",
  "Ȥ" : "Ȥ",
  "Œ" : "Œ",
  "ȥ" : "ȥ",
  "œ" : "œ",
  "Ȧ" : "A",
  "Ŕ" : "R",
  "ȧ" : "a",
  "ŕ" : "r",
  "Ȩ" : "E",
  "Ŗ" : "R",
  "ȩ" : "e",
  "ŗ" : "r",
  "Ȫ" : "O",
  "Ř" : "R",
  "ȫ" : "o",
  "ř" : "r",
  "Ȭ" : "O",
  "Ś" : "S",
  "ȭ" : "o",
  "ś" : "s",
  "Ȯ" : "O",
  "Ŝ" : "S",
  "ȯ" : "o",
  "ŝ" : "s",
  "Ȱ" : "O",
  "Ş" : "S",
  "ȱ" : "o",
  "ş" : "s",
  "Ȳ" : "Y",
  "Š" : "S",
  "ȳ" : "y",
  "š" : "s",
  "ȴ" : "ȴ",
  "Ţ" : "T",
  "ȵ" : "ȵ",
  "ţ" : "t",
  "ȶ" : "ȶ",
  "Ť" : "T",
  "ȷ" : "ȷ",
  "ť" : "t",
  "ȸ" : "ȸ",
  "Ŧ" : "Ŧ",
  "ȹ" : "ȹ",
  "ŧ" : "ŧ",
  "Ⱥ" : "Ⱥ",
  "Ũ" : "U",
  "Ȼ" : "Ȼ",
  "ũ" : "u",
  "ȼ" : "ȼ",
  "Ū" : "U",
  "Ƚ" : "Ƚ",
  "ū" : "u",
  "Ⱦ" : "Ⱦ",
  "Ŭ" : "U",
  "ȿ" : "ȿ",
  "ŭ" : "u",
  "ɀ" : "ɀ",
  "Ů" : "U",
  "ů" : "u",
  "Ű" : "U",
  "ű" : "u",
  "Ų" : "U",
  "ų" : "u",
  "Ŵ" : "W",
  "ŵ" : "w"
}